Angola->Luanda
Argelia->Argel
Benín->Porto-Novo
Botsuana->Gaborone
Burkina Faso->Uagadugú
Burundi->Buyumbura
Cabo Verde->Praia
Camerún->Yaundé
Chad->Yamena
Comoras->Moroni
Congo->Brazzaville
Costa de Marfil->Yamusukro
Egipto->El Cairo
Eritrea->Asmara
Esuatini->Mbabane
Etiopía->Adís Abeba
Gabón->Libreville
Gambia->Banjul
Ghana->Accra
Guinea->Conakri
Guinea->Ecuatorial	Malabo
Guinea-Bisáu->Bisáu
Kenia->Nairobi
Lesoto->Maseru
Liberia->Monrovia
Libia->Trípoli
Madagascar->Antananarivo
Malaui->Lilongüe
Malí->Bamako
Marruecos->Rabat
Mauricio->Port Louis
Mauritania->Nuakchot
Mozambique->Maputo
Namibia->Windhoek
Níger->Niamey
Nigeria->Abuya
República Centroafricana->Bangui
República Democrática del Congo->Kinsasa
Ruanda->Kigali
Santo Tomé y Príncipe->Santo Tomé
Senegal->Dakar
Seychelles->Victoria
Sierra Leona->Freetown
Somalia->Mogadiscio
Sudáfrica->Pretoria
Sudán->Jartum
Sudán del Sur->Yuba
Tanzania->Dodoma
Togo->Lomé
Túnez->Túnez
Uganda->Kampala
Yibuti->Yibuti
Zambia->Lusaka
Zimbabue->Harare
Antigua y Barbuda->Saint John
Argentina->Buenos Aires
Bahamas->Nasáu
Barbados->Bridgetown
Belice->Belmopán
Bolivia->Sucre
Brasil->Brasilia
Canadá->Ottawa
Chile->Santiago
Colombia->Bogotá
Costa Rica->San José
Cuba->La Habana
Dominica->Roseau
Ecuador->Quito
El Salvador->San Salvador
Estados Unidos->Washington D. C.
Granada->Saint George
Guatemala->Guatemala
Guyana->Georgetown
Haití->Puerto Príncipe
Honduras->Tegucigalpa
Jamaica->Kingston
México->México
Nicaragua->Managua
Panamá->Panamá
Paraguay->Asunción
Perú->Lima
República Dominicana->Santo Domingo
San Cristóbal y Nieves->Basseterre
San Vicente y las Granadinas->Kingstown
Santa Lucía->Castries
Surinam->Paramaribo
Trinidad y Tobago->Puerto España
Uruguay->Montevideo
Venezuela->Caracas
Afganistán->Kabul
Arabia Saudita->Riad
Armenia->Ereván
Azerbaiyán->Bakú
Bangladés->Daca
Baréin->Manama
Birmania->Naipyidó
Brunéi->Bandar Seri Begawan
Bután->Thimphu
Camboya->Nom Pen
Catar->Doha
China->Pekín
Corea del Norte->Pionyang
Corea del Sur->Seúl
Emiratos Árabes Unidos->Abu Dabi
Filipinas->Manila
Georgia->Tiflis
India->Nueva Delhi
Indonesia->Yakarta
Irak->Bagdad
Irán->Teherán
Israel->Jerusalén
Japón->Tokio
Jordania->Amán
Kazajistán->Astaná
Kirguistán->Biskek
Kuwait->Kuwait City
Laos->Vientián
Líbano->Beirut
Malasia->Kuala Lumpur
Maldivas->Malé
Mongolia->Ulán Bator
Nepal->Katmandú
Omán->Mascate
Pakistán->Islamabad
Palestina->Jerusalén Este
Singapur->Singapur
Siria->Damasco
Sri Lanka->Sri Jayawardenapura Kotte
Tailandia->Bangkok
Taiwán->Taipéi
Tayikistán->Dusambé
Turkmenistán->Asjabad
Turquía->Ankara
Uzbekistán->Taskent
Vietnam->Hanói
Yemen->Saná
Albania->Tirana
Alemania->Berlín
Andorra->Andorra la Vieja
Austria->Viena
Bélgica->Bruselas
Bielorrusia->Minsk
Bosnia-Herzegovina->Sarajevo
Bulgaria->Sofía
Chipre->Nicosia
Croacia->Zagreb
Dinamarca->Copenhague
Eslovaquia->Bratislava
Eslovenia->Liubliana
España->Madrid
Estonia->Tallin
Finlandia->Helsinki
Francia->París
Grecia->Atenas
Hungría->Budapest
Irlanda->Dublín
Islandia->Reikiavik
Italia->Roma
Kosovo->Pristina
Letonia->Riga
Liechtenstein->Vaduz
Lituania->Vilna
Luxemburgo->Luxemburgo
Macedonia del Norte->Skopie
Malta->La Valeta
Moldavia->Chisináu
Mónaco->Mónaco
Montenegro->Podgorica
Noruega->Oslo
Países Bajos->Ámsterdam
Polonia->Varsovia
Portugal->Lisboa
Reino Unido->Londres
República Checa->Praga
Rumania->Bucarest
Rusia->Moscú
San Marino->San Marino
Serbia->Belgrado
Suecia->Estocolmo
Suiza->Berna
Ucrania->Kiev
Vaticano->Vaticano
Australia->Canberra
Fiyi->Suva
Islas Marshall->Majuro
Islas Salomón->Honiara
Kiribati->Tarawa
Micronesia->Palikir
Nauru->Yaren
Nueva Zelanda->Wellington
Palaos->Melekeok
Papúa Nueva Guinea->Puerto Moresby
Samoa->Apia
Timor->Oriental	Dili
Tonga->Nukualofa
Tuvalu->Funafuti
Vanuatu->Port Vilali